
########################
#----------------------#
#---#--------------#---#
#---####---###---###---#
#---#--------------#---#
#---#------###---------#
#---#------#-#-----#---#
#---#------------------#
#---#--------------#---#
#---####---###---###---#
#----------------------#
#---################---#
########################